b........b
.......ww.
..bb~~....
ww..bbb~~.
.w........
..bb..w..b
..........
..........
..........
b....b...b