be..e...eb
.......ww.
..bb~~....
ww..wbb~~.
.w........
..bb..w..b
.........b
..........
...bbb....
b..sfb...b