e...e....e
...b..w.~.
..w.......
....w..ww.
~..b...~..
.......bbb
.......bb.
..b..b....
.b..b....b
...bfbs...