..........
.......ww.
..bb~~....
....bbb...
.w........
..bb..w.b.
..........