be..e...eb
.......ww.
..bb~~....
ww..bbb~~.
.w........
..bb..w..b
..........
..........
...bbb....
b..sfb...b