e...e....e
....w.....
....w.....
.b..b..bb.
~b.bbb.bb~
...bbb....
..b...b...
........b.
.b.bbb....
...bfbs...